"sp","total_hab","fcover_51","fcover_77","fcover_91","fcover_00","tot_change"
"ACNARB",33838,3944,9062,14702,14320,10376
"ADEPAV",10548,2329,3966,3392,3729,1400
"ADERIC",16534,1698,4353,3859,4539,2841
"AIPMIN",37211,5928,11762,15599,15822,9894
"ALBLEB",10394,594,2025,3621,3634,3040
"ALBPRO",15788,1188,2585,4748,4810,3622
"ALCLAT",16364,2794,6369,9976,9319,6525
"ALLCRA",20617,3928,7507,11324,11603,7675
"ALLRAC",7543,2517,4004,3360,3791,1274
"ALSBRY",2213,1028,1435,1790,1668,640
"ALSPOR",15780,2156,5326,9984,9372,7216
"AMYELE",8611,2768,4442,3819,4316,1548
"ANAPER",34397,4279,9477,15134,14762,10483
"ANDINE",23538,3048,7266,10919,10896,7848
"ANNGLA",26410,3719,7069,8139,8830,5111
"ANNMON",10235,1033,2225,4303,4522,3489
"ARDELL",27399,5126,10464,14601,14608,9482
"ARDGLA",5284,930,2368,3054,2705,1775
"ARDOBO",14284,2937,4786,4068,4539,1602
"ARTALT",12866,1005,3557,6445,6547,5542
"AVIGER",20428,1510,3560,5205,5515,4005
"BADPEN",2831,681,1072,1768,1772,1091
"BIXORE",41381,6461,13066,18062,18111,11650
"BOCFRU",33838,3944,9062,14702,14320,10376
"BONUMB",4076,971,1610,1422,1596,625
"BOUSUC",19311,2463,5207,4453,5251,2788
"BOUVIR",12924,2860,4643,3906,4484,1624
"BRUAME",41940,6796,13481,18494,18553,11757
"BRUDEN",20415,2944,6875,11673,11259,8315
"BRULAC",639,469,542,595,559,90
"BUCBUC",32583,4397,9325,11941,12677,8280
"BUCTET",17365,3184,6868,11100,10456,7272
"BUNGLA",13559,1450,3047,4086,4577,3127
"BURSIM",16415,2380,4087,3112,3769,1389
"BUXPOR",12272,3385,5723,6255,6522,3137
"BUXVAH",37905,5956,11834,15700,15971,10015
"BYRCRA",6374,588,1005,2705,2792,2204
"BYRLUC",12377,1577,2896,4473,4828,3251
"BYRSPI",10536,889,2739,3524,3105,2216
"BYRWAD",4851,1512,2337,3484,3154,1642
"CALANT",21307,3319,6752,7164,7122,3803
"CALKRU",3574,1416,2129,2625,2425,1009
"CALPAL",10064,1139,1949,1512,1768,629
"CANWIN",10938,1125,2873,2854,3472,2347
"CAPFRO",3649,344,573,393,557,213
"CASACU",24652,3223,6184,7054,7756,4533
"CASARB",13862,2352,5031,8476,7714,5362
"CASDEC",22063,3134,7230,7792,7793,4659
"CASELA",42075,6489,13138,18163,18260,11771
"CASEQU",10371,1137,1713,1430,1656,519
"CASGUI",23460,3227,7618,8493,8577,5350
"CASSYL",26512,4715,9980,15635,15153,10438
"CECSCH",18900,3169,6769,12535,11874,8705
"CEDODO",41940,6796,13481,18494,18553,11757
"CEIPEN",25791,3283,6431,7692,8336,5053
"CELTRI",3864,585,1153,1001,1274,689
"CESCIT",32128,5994,12183,17496,17339,11345
"CESLAU",25497,4194,9383,13320,13246,9052
"CESMAC",16644,3845,6872,10578,9972,6127
"CHICOM",15523,2649,5299,5403,5327,2678
"CHIDOM",18183,4254,8065,10119,9898,5644
"CHIHOL",2409,681,1132,951,1082,401
"CHIVEN",19349,3171,6533,7100,6916,3745
"CHRARG",20647,3388,7124,7749,7660,4272
"CHRCAI",37211,5928,11762,15599,15822,9894
"CHRICA",10852,920,1539,2598,2613,1693
"CHROLI",14591,1378,2673,3461,3753,2375
"CHRPAU",16559,1660,4019,5931,6266,4606
"CINELO",26008,4089,9208,14423,14087,9998
"CINMON",19325,3424,7834,10096,9903,6479
"CITCAU",6541,1564,3216,4081,3746,2182
"CITSIN",10341,1515,3975,6597,6232,4717
"CITSPI",25174,3066,7630,9332,9607,6541
"CLIEGG",10229,1922,4243,6990,6473,4551
"CLIERO",1466,885,1091,1275,1217,332
"CLIHIR",34532,3972,9134,14803,14469,10497
"CLUCLU",5349,1252,2183,3396,3228,1976
"CLUGUN",10226,2296,4459,7186,6616,4320
"CLUMIN",22894,4223,7103,7374,7902,3679
"CLUROS",13384,2874,4473,4009,4453,1579
"COCCOS",6087,2079,3325,2853,3209,1130
"COCDIV",18165,3355,5384,4479,5171,1816
"COCKRU",3634,654,1061,796,963,309
"COCMIC",5286,954,1716,1615,1839,885
"COCPUB",11373,2903,4978,5018,5442,2539
"COCPYR",4633,1842,2612,3462,3245,1403
"COCRUG",12265,1586,4532,6003,5512,3926
"COCSIN",559,335,415,432,442,107
"COCSWA",12535,2325,5083,8209,7773,5448
"COCUVI",37211,5928,11762,15599,15822,9894
"COCVEN",24360,3318,7491,7677,8299,4981
"COFARA",20481,2520,6191,11437,11209,8689
"COJARB",17914,3654,5717,4790,5447,1793
"COLARB",9757,2254,3589,3153,3613,1359
"COLELL",3755,543,843,517,684,141
"COLVER",5653,910,1966,1949,2282,1372
"COMDOD",5826,862,1504,1094,1379,517
"COMGLA",4476,1830,2852,2452,2745,915
"CONERE",16080,1852,3367,4198,4677,2825
"CORALL",20807,2331,6094,11137,10813,8482
"CORBOR",14950,2375,5740,8688,7941,5566
"CORCOL",14162,955,3040,5148,5557,4602
"CORHIR",6955,824,1385,992,1290,466
"CORLAE",32024,4385,9105,11495,12138,7753
"COROBO",37211,5928,11762,15599,15822,9894
"CORRIC",21049,2531,4966,6049,6686,4155
"CORSUL",14668,1966,4642,9048,8331,6365
"CRECUJ",21394,3303,5678,6088,6744,3441
"CRELIN",7531,846,1548,1474,1747,901
"CREPOR",10487,1145,1723,1450,1673,528
"CRIPOR",27958,5461,10879,15033,15050,9589
"CROAST",5547,762,1655,1673,2024,1262
"CROBET",14257,1599,3124,2895,3534,1935
"CRODIS",5043,705,1225,897,1122,417
"CROFLA",8893,1195,2502,1829,2349,1154
"CROGLA",4959,743,1207,798,1039,296
"CROIMP",6988,1011,1967,4036,4062,3051
"CROPOE",914,590,786,844,802,212
"CRORHA",3468,642,1114,780,950,308
"CSSGUI",18644,3927,8048,10854,10310,6383
"CUPAME",26833,3890,8075,11778,11860,7970
"CYAARB",14895,2579,5889,9958,9324,6745
"CYABOR",32128,5994,12183,17496,17339,11345
"CYNFLE",12773,1861,3034,2391,2821,960
"CYNHAS",8058,908,1866,1415,1895,987
"CYNPOR",12996,2109,3464,2734,3222,1113
"CYRRAC",855,718,799,833,822,104
"DACEXC",11829,2072,4276,6835,6196,4124
"DAPAME",5550,1140,2212,3790,3413,2273
"DAPHEL",9904,2025,3124,2473,2835,810
"DAPPHI",11597,2426,4685,8010,7352,4926
"DELREG",30227,3746,8173,12671,12473,8727
"DENARB",22628,4449,8591,13916,13370,8921
"DENLAU",12834,1905,4705,7617,7231,5326
"DIOSIN",8218,2860,4429,3812,4250,1390
"DITMYR",1906,800,1152,1472,1270,470
"DRYALB",12030,3259,5564,6020,6322,3063
"DRYGLA",3440,1501,2157,2588,2399,898
"DRYILI",13403,2722,4395,3688,4163,1441
"ELAXYL",16056,2202,3833,3699,4136,1934
"ERIFRU",12258,1712,2858,2283,2689,977
"ERYARE",4761,683,1117,713,936,253
"ERYBER",34397,4279,9477,15134,14762,10483
"ERYBRE",16643,1840,3553,2724,3260,1420
"ERYPOE",24581,3735,7123,11890,11893,8158
"ERYROT",12104,1299,2547,2216,2754,1455
"ERYRUF",10371,1137,1713,1430,1656,519
"ERYURB",18030,3662,5727,4810,5464,1802
"EUGAXI",7156,890,1712,1353,1688,798
"EUGBIF",26923,3596,8408,9510,9860,6264
"EUGBOR",6049,1369,2844,3540,3168,1799
"EUGCON",559,335,415,432,442,107
"EUGCOR",13242,1068,2868,6058,6188,5120
"EUGDOM",21153,3458,7304,7913,7713,4255
"EUGEGG",9890,2095,4205,6875,6310,4215
"EUGFOE",13728,2191,3625,2860,3399,1208
"EUGLIG",15039,1934,3338,2859,3420,1486
"EUGMON",29160,4289,9784,10670,11160,6871
"EUGPAD",8218,2860,4429,3812,4250,1390
"EUGPSE",19863,2926,6108,6131,6277,3351
"EUGRHO",17257,1781,4518,6426,6960,5179
"EUGSTA",8069,1986,3509,5753,5183,3197
"EUGSTE",24585,3477,8179,14136,13548,10071
"EUGWOO",2799,574,917,700,852,278
"EUPPET",7098,830,1567,1163,1549,719
"EXOCAR",7343,916,1857,1338,1801,885
"EXOPAN",12271,2488,4590,4059,4353,1865
"FAROCC",20981,3372,7341,8111,8075,4703
"FICAME",16355,3171,6871,9466,8869,5698
"FICCIT",33555,4597,10071,12386,12855,8258
"FICCRA",37211,5928,11762,15599,15822,9894
"FICTRI",33838,3944,9062,14702,14320,10376
"FORSEG",3128,493,743,450,613,120
"GARHES",3322,557,1151,1699,1712,1155
"GARPOR",8813,1036,3138,4069,3702,2666
"GAUATT",13158,1000,1737,2533,2797,1797
"GENAME",22010,2473,6449,8315,8041,5568
"GESPED",16273,3025,5750,9093,9148,6123
"GOEELE",9098,1657,3902,4041,4000,2343
"GOMLIN",9157,1532,3611,6121,5681,4149
"GONHIR",25085,5040,9716,15081,14442,9402
"GONPOR",720,530,621,671,637,107
"GOSHIR",7365,653,1249,1204,1515,862
"GUABLA",8721,2050,3581,6372,6114,4064
"GUACAR",1095,530,703,810,765,235
"GUAFRA",26532,3659,8642,9373,9563,5904
"GUAGLA",7358,1917,3217,5195,4661,2744
"GUAGUI",26712,4183,9472,15287,14939,10756
"GUAOBT",8218,2860,4429,3812,4250,1390
"GUAOFF",5961,770,1481,1052,1335,565
"GUASAN",1293,364,516,359,416,52
"GUAULM",16699,1369,4289,7549,7630,6261
"GUEELL",6405,841,1704,1185,1511,670
"GUEKRU",4346,624,1012,648,843,219
"GUEOVA",13601,2903,5942,9101,8662,5759
"GUEPUN",7064,1864,3218,3797,3943,2079
"GUESCA",16373,3296,5547,5367,5853,2557
"GUEVAL",11848,1648,4591,6314,5986,4338
"GYMLAT",17593,3268,5257,4298,4990,1722
"GYMLUC",11118,2484,4072,3308,3852,1368
"HAESAL",3014,1205,1794,2110,1916,711
"HAMAXI",21641,3860,6616,6841,7311,3451
"HEDARB",3416,997,1814,2275,1974,977
"HELJAM",16495,2362,4021,3882,4419,2057
"HENFAS",24026,3142,7764,13704,13106,9964
"HENMAC",9500,2074,4069,6669,6099,4025
"HENSQU",4644,1598,2403,3330,3045,1447
"HIBELA",29552,3403,7748,12219,12014,8611
"HIBTIL",27283,5118,10454,14581,14591,9473
"HIECLU",37770,6263,12177,16031,16264,10001
"HIPMAN",9616,1495,2781,3776,4070,2575
"HIRRUG",10979,2190,4719,7382,6670,4480
"HIRTRI",33838,3944,9062,14702,14320,10376
"HOMRAC",12542,1745,4854,6547,5998,4253
"HURCRE",17497,2011,4271,8238,8343,6332
"HYMCOU",19604,1625,4479,6952,7234,5609
"HYPTRI",1493,446,684,501,574,128
"ILENIT",4142,1447,1792,3399,3303,1856
"ILESID",25279,3505,8251,14237,13697,10192
"ILEURB",8102,2852,4419,3792,4233,1381
"INDSUF",14889,1613,2767,2680,3041,1428
"INGLAU",18042,2439,6020,10920,10376,7937
"INGVER",22422,2826,7242,12895,12503,9677
"IXOFER",18966,3183,6535,7095,6923,3740
"JACARB",5761,633,1118,675,968,335
"JACBER",4810,730,1282,980,1213,483
"JATGOS",8869,795,1313,1382,1658,863
"JATHER",28166,4047,7618,9159,9722,5675
"KOAPOL",34397,4279,9477,15134,14762,10483
"KRUFER",15118,2221,4091,3185,3933,1712
"LAEPRO",23910,3134,7754,13684,13089,9955
"LAGRAC",11979,1006,1672,1484,1717,711
"LANCAM",16200,1593,3447,3052,3727,2134
"LANINV",17186,1665,3507,4447,5010,3345
"LEULEU",17190,1775,3625,4175,4829,3054
"LICBRI",559,335,415,432,442,107
"LICPAR",20644,3193,5737,5421,5965,2772
"LONGLA",3787,1391,2122,1763,2026,635
"LONHEP",27958,5461,10879,15033,15050,9589
"LONSER",17914,3654,5717,4790,5447,1793
"LYOSTA",15432,1877,4598,7114,6844,4967
"MACLUN",16437,1143,2484,3670,3761,2618
"MACPOR",6119,975,2023,2100,2406,1431
"MAGPOR",2352,1134,1450,1990,1829,695
"MAGSPL",24026,3142,7764,13704,13106,9964
"MALCOC",33766,5054,10080,12883,13453,8399
"MALFUC",5003,1040,2264,2487,2246,1206
"MAMAME",18728,2817,5794,6222,6113,3296
"MANBID",10506,1506,2848,3367,3185,1679
"MANIND",15702,1268,4423,8302,8136,6868
"MANPLE",18608,3682,5789,4891,5596,1914
"MARMIC",41381,6461,13066,18062,18111,11650
"MARNOB",19319,3117,6444,6986,6818,3701
"MATDOM",7832,1949,3419,5595,5022,3073
"MAYELO",34397,4279,9477,15134,14762,10483
"MAYLAE",13352,1942,4003,3640,3826,1884
"MAYPON",8796,2880,4491,3893,4382,1502
"MECLAT",7900,1922,3406,5614,5060,3138
"MELAZE",37905,5956,11834,15700,15971,10015
"MELBIJ",19479,2432,4379,5152,5733,3301
"MELHER",15126,2743,6035,10046,9392,6649
"MELOBT",24469,3469,8169,14116,13531,10062
"MELTOM",7490,880,1823,1238,1697,817
"MICCAL",12945,2142,5056,8246,7863,5721
"MICFOV",3182,634,1406,1765,1479,845
"MICGAR",6167,1016,2552,3374,2881,1865
"MICGUY",8292,2004,3559,5852,5277,3273
"MICIMP",20073,1885,5398,7114,6862,4977
"MICLAE",35828,5552,11596,16749,16575,11023
"MICMIR",4689,1358,2455,3002,2665,1307
"MICPAC",948,634,822,885,841,207
"MICPRA",24655,2784,7006,10508,10181,7397
"MICRAC",15018,2403,5855,9067,8385,5982
"MICSER",14415,2156,4386,9690,9151,6995
"MICSIN",5268,1584,2449,3823,3443,1859
"MICTET",17955,2683,6459,10490,9781,7098
"MICTHO",12393,925,2526,2956,2854,1929
"MORCIT",13702,934,2258,2316,2340,1406
"MOSXER",3236,604,958,660,819,215
"MOUHEL",559,335,415,432,442,107
"MUNCAL",14634,1049,2079,3032,3313,2264
"MYRAMA",11801,2273,4986,5747,5451,3178
"MYRBOR",6780,945,2343,2497,2944,1999
"MYRCER",27404,5102,9391,13318,12959,7857
"MYRCIT",6001,1070,1818,2100,2287,1217
"MYRCOR",11055,2054,4434,7571,6956,4902
"MYRDEF",13176,2203,5279,7943,7269,5066
"MYRFAL",6926,1689,3048,4517,4095,2406
"MYRFLO",694,28,72,101,149,121
"MYRGUI",12660,1535,2767,3853,3819,2284
"MYRSPL",16191,2367,5570,10099,9434,7067
"NECCOR",25921,4033,8738,9827,10114,6081
"NECKRU",26777,2952,6715,10803,10756,7804
"NECMEM",19740,2601,6450,11221,10800,8199
"NECPAT",13501,2980,4722,4142,4620,1640
"NECTUR",11342,3111,5463,6482,6326,3215
"NEEBUX",12745,2546,4168,3569,4020,1474
"NEORES",13479,2941,4789,4811,5075,2134
"OCHPYR",23910,3134,7754,13684,13089,9955
"OCOCUN",559,335,415,432,442,107
"OCOFLO",32128,5994,12183,17496,17339,11345
"OCOLEU",20451,3438,7149,12885,11996,8558
"OCOSPA",1794,1055,1424,1533,1459,404
"OCOWRI",7199,1386,1948,4058,3888,2502
"ORMKRU",16221,2560,5971,9375,8653,6093
"OSSKRU",12241,1880,3619,8089,7988,6108
"OURLIT",8476,830,2120,2898,2722,1892
"OXALAN",8912,2888,4501,3913,4399,1511
"PALALP",4713,923,1637,3422,3147,2224
"PALCRO",18080,1637,3570,7698,7260,5623
"PALRIP",22973,3054,7439,12693,12176,9122
"PARCRE",4729,868,1719,2895,2731,1863
"PERAME",39651,6002,12132,16706,16987,10985
"PETDOM",20504,3147,6038,8742,9311,6164
"PHIMYR",3763,555,836,923,1055,500
"PHLCOW",9059,1015,1812,2366,2664,1649
"PHYCUN",6264,563,1328,1157,1512,949
"PHYEPI",15836,3218,5201,4289,4860,1642
"PHYJUG",10178,797,1973,1628,1766,969
"PICACU",13397,1416,3535,4529,5070,3654
"PICEXC",37211,5928,11762,15599,15822,9894
"PICPEN",26395,3659,8116,9369,9815,6156
"PILRAC",2108,384,492,514,580,196
"PIMRAC",13317,2724,4547,4916,5229,2505
"PINCAR",24585,3477,8179,14136,13548,10071
"PINCOR",25813,5097,9984,15509,14929,9832
"PIPADU",24882,4771,9414,14673,14113,9342
"PIPAMA",36775,5375,11625,16771,16699,11324
"PIPBLA",20657,3230,6844,12686,11767,8537
"PIPGLA",17899,2910,6010,11389,10771,7861
"PIPHIS",22119,3098,7262,13159,12661,9563
"PIPJAC",28235,4294,8281,9590,10298,6004
"PIPMAR",15410,3285,6974,7756,7754,4469
"PIPUMB",19740,2601,6450,11221,10800,8199
"PISALB",7909,949,1878,1682,2086,1137
"PISCAR",4163,324,626,551,794,470
"PISSUB",32128,5994,12183,17496,17339,11345
"PITDUL",5647,615,1030,666,936,321
"PITUNG",4220,665,1391,1007,1290,625
"PLUALB",20233,2048,4823,6686,7291,5243
"PLUCAR",36187,5372,10849,14483,14861,9489
"PLUOBT",1535,841,1174,1222,1255,414
"PODCOR",11181,1173,1795,1551,1822,649
"POIFLO",25590,3603,6711,7565,8247,4644
"POIPUN",13634,1712,3379,7257,7296,5584
"POUDIC",13133,2752,4382,3657,4121,1369
"POUMUL",37770,6263,12177,16031,16264,10001
"PREMON",8587,1954,3925,5648,5074,3120
"PROJUL",6895,861,1697,1181,1581,720
"PROPAL",14572,1480,3127,2863,3475,1995
"PRUMYR",5633,2149,3299,2919,3236,1087
"PSESPU",4024,1504,2279,1913,2187,683
"PSIAMP",7220,2201,3539,3542,3926,1725
"PSIGUA",25049,3053,7762,11525,11252,8199
"PSYBER",11062,2179,4742,7617,6925,4746
"PSYBRA",15267,2163,4978,9512,8754,6591
"PSYDOM",17637,2817,5939,5819,5887,3070
"PSYGRA",20299,2936,6865,11653,11242,8306
"PSYMAL",2940,813,1478,1940,1648,835
"PSYMAR",11422,1189,1914,1648,1905,716
"PSYPUB",20704,4320,7657,8757,8622,4302
"PTEIND",37770,6263,12177,16031,16264,10001
"QUACYN",9487,1000,2722,2407,3026,2026
"QUAIND",6671,832,1714,1128,1485,653
"QUATUR",22796,3478,6804,7776,7905,4427
"RANACU",20786,3026,5831,5080,5699,2673
"RAUNIT",22305,2370,5970,6790,7428,5058
"RAVURB",1868,611,1032,1372,1158,547
"REYKRU",12388,3393,5733,6275,6539,3146
"REYUNC",5074,698,1183,785,1024,326
"REYVIV",1188,357,515,368,415,58
"RHIMAN",10733,815,1536,1971,2050,1235
"ROCACA",7608,911,1883,1330,1799,888
"RONINE",18360,3650,6132,6215,6681,3031
"ROYBOR",23524,3030,7757,11350,11415,8385
"SAMDOD",20276,3289,5580,6096,6806,3517
"SAMSAM",10213,1020,2644,2558,3155,2135
"SAMSPI",11111,2382,4456,5160,5091,2709
"SAPLAU",20359,3871,8067,11616,11016,7145
"SAPSAP",6542,886,1607,2433,2601,1715
"SAVSES",6144,670,2297,2285,2735,2065
"SCHFRU",28127,4178,8156,10110,10874,6696
"SCHGLE",20415,2944,6875,11673,11259,8315
"SCHMOR",18424,2812,6148,11159,10276,7464
"SCHOBO",8218,2860,4429,3812,4250,1390
"SENPOL",5444,860,1399,1018,1267,407
"SENSIA",42075,6489,13138,18163,18260,11771
"SIDCUB",9230,1914,2997,2694,3023,1109
"SIDFOE",18049,3347,5374,4459,5154,1807
"SIDOBO",4114,788,1271,899,1116,328
"SIDPOR",15399,3273,5371,5667,5886,2613
"SIDSAL",17471,3327,5312,4378,5022,1695
"SIMTUL",14356,2509,4363,8923,8560,6051
"SIPDEN",4729,868,1719,2895,2731,1863
"SLOAMY",8218,2860,4429,3812,4250,1390
"SLOBER",7182,1794,3093,4916,4414,2620
"SOLENS",27399,5126,10464,14601,14608,9482
"SOLRUG",18654,2076,5624,10285,9925,7849
"SOLTOR",19405,1668,4648,7499,7583,5915
"SPACAM",30201,4144,8883,13792,13539,9395
"SPOMOM",20539,1700,4261,8058,8064,6364
"STAMON",7072,739,1193,1298,1519,780
"STEACU",6546,854,1611,1564,1799,945
"STEAPE",37211,5928,11762,15599,15822,9894
"STESIN",11713,3050,5308,5823,6080,3030
"SWIMAC",41381,6461,13066,18062,18111,11650
"SWIMAH",8267,1044,1648,2284,2518,1474
"SYMMAR",22200,4195,7031,7273,7753,3558
"SYMMIC",3761,765,1350,1581,1398,633
"SYZJAM",21736,2839,7136,12333,11782,8943
"SYZMAL",24585,3477,8179,14136,13548,10071
"TABCIT",24026,3142,7764,13704,13106,9964
"TABHAE",24354,2671,6114,11340,11340,8669
"TABHET",15401,2113,4633,4721,4748,2635
"TABKAR",4913,1895,2973,2573,2882,987
"TABRIG",8972,1203,3408,4522,3992,2789
"TABSCH",7042,1503,2907,5012,4514,3011
"TAMIND",16276,1438,3455,4620,5152,3714
"TECGRA",37770,6263,12177,16031,16264,10001
"TECSTA",22169,1977,4478,6099,6549,4572
"TERCAT",31811,4372,9057,11405,12062,7690
"TERSTA",9789,2687,4533,4509,4862,2175
"TETBAL",30921,3774,8245,12772,12622,8848
"TETBIF",5294,1509,2332,4183,3825,2316
"TETELA",19142,2613,5911,5836,6045,3432
"TETURB",12731,2325,5164,8518,7763,5438
"THEGRA",16190,1772,3991,6381,6426,4654
"THEPOP",19393,1596,3260,4704,5095,3499
"THOPOR",5152,708,1266,872,1119,411
"THOSTR",7440,2503,3976,3336,3763,1260
"THRMOR",12606,1954,3547,4178,4764,2810
"TOUFIL",21340,3274,6456,8801,9037,5763
"TRELAM",7638,1341,2376,5435,5296,3955
"TREMIC",29477,3289,7551,11993,11831,8542
"TRIHIR",29762,3760,8104,12420,12579,8819
"TRIPAL",20706,3639,8066,11888,11364,7725
"TRITRI",2185,513,875,622,737,224
"TRORAC",17918,3093,6221,6427,6423,3330
"TUROCC",14970,2825,6071,10032,9449,6624
"UREBAC",17004,3801,6340,10896,10867,7066
"VACFAR",11833,1054,3284,3021,3702,2648
"VARBEL",559,335,415,432,442,107
"VARPOL",9946,694,2330,2434,2286,1592
"VARRUP",1224,401,595,447,499,98
"VITDIV",20700,2806,6717,11586,11207,8401
"WALLAM",4151,1569,2361,1986,2267,698
"XYLBUX",18165,3355,5384,4479,5171,1816
"XYLSCH",559,335,415,432,442,107
"ZANFLA",7543,2517,4004,3360,3791,1274
"ZANMAR",22714,3317,8115,10581,10708,7391
"ZANMON",12279,908,3622,5282,5649,4741
"ZANPUN",4132,559,1109,1462,1655,1096
"ZAPPOR",9255,953,2401,2110,2680,1727
"ZIZRET",4529,560,923,541,754,194
